imma watch youtube and knock out now so - peace
bet send me - venmo
thanks - bro
ok tht and the shirt for me - bro
yeah go classic - then
hmmm first one with red ribbon looks p dope, but second one is the - classic
yh isnt there no white for real - scarfs
I feel like shed like to have it regardless - tbh
griffindor is defs her - fave
i remember doing the test but - idr
idk what house she is - tho
she read the last book the day it came - out
finished it in like a few - days
biggest fan in my - fam
I tried finding lion, - king
my mom is about ur size so - yh
lmao imma try to find an akame shirt - now
u gunna judge - me
gotta finish some stuff for - school
ill look in 10 min - lol
too tired to - google
bet send me link of - site
im confused tho, ur not making free shipping so u want me to get - something
the answer is wayyyyy too - much
might have taken it - out
I wanna know how the fuck "like" isnt one - of
yerr wrote the future work section of one of my - paper
idk how I never saw this, p sure theyre australian - too
hopefully bobbys is - better
thts an - oof
got a score - of
This is - fun
Running my model for 100 of ur sentences, getting most of em - wrong
Like legit I take pics of them none of these fucks take pics of - me
Uhuh trying to look for another - photo
But she's rather - not
But then u have 4 foot tall girls like Anna who think a 6 foot guy is - optimal
Tht doesn't make me feel happy - ngl
I'm not looking for white girls - tho
I like how height matters tht fucking - much
IMMA FAMOUS YOUTBER RINA, - OBVIOUSLY
We went to his show - lmao
Next time we hang we need a group - photo
Just like for group, - purposes
then try and find one with a - group
right I need to make it look like a hallmark photo - bet
trying to find pics with indiana, - even
like joshin doesnt love - this
and my look changed since - college
I need ones that are - recent
lmao would tht be bad im clrly making a funny - face
eh better than - nothing
and my only pic with me and indiana is when hes like a - puppy
was I at ur last - bday
idk who tht is but - bet
ill show u the photos when I got em - all
trying to get some for these apps, but I usually take the - photos
yer gonna go to sleep now, see - ya
I swear they just look at dic pics as the guns float by the other - screens
that is if they do their fucking jobs on that last fucking - part
like if ur gonna know everything we - do
can u fucking be useful with - it
let the nsa observe - them
but wait hear me - out
whole internet needs more - laws
too much like the wild - west
I was floored and immediately got one of - these
I think dashlane is free but its a limited number - of
and that the passwords are trained to be as ahrd as possible to - crack
another thing good about it is that your paying ppl to tell u if there was a - compromise
for most I had it auto generate a super hard one - lmao
next time we hang ill show u how it - works
otherwise its gonna take - forever
its all - sorted
for the rest of the sentences to test imma just- take
dude has a british accent, ik u like - that
its so heavily encrypted they wouldnt - bother
that can be decrypted in - seconds
obvi its more complex, watch the - vid
yeah but if they got hacked the hacker wouldnt get - much
yh imo its worth getting a password - manager
thts a record - lmaooo
length, and a few numbers is already a head - start
unless of course they employ a dictionary and similar methods im using to predict ur - speech
and ur not rich so they aint gonna waste - time
its fucking - terrifying
you ever see the video of how - they
when ur online date doesnt go - well
which baffles me since youve legit said those words - before
at least its not a psycho - like
now thats a top teir tech - meme
this has me laughing way too - hard
see its not just my prediction alg tht - sucks
this is me - lmao
I think what u mean to say is - like
kids are the money makers, hollywood already knows - it
family friendly - content
heard so many ppl rave but never had time to - watch
was it really that good - tho
like I think if we talk about politics it might do - better
